positive	positive
good	positive
great	positive
excellent	positive
excellence	positive
fine	positive
nice	positive
desirable	positive
exquisite	positive
fabulous	positive
ideal	positive
marvelous	positive
perfect	positive
perfection	positive
splendid	positive
wonderful	positive
classy	positive
elegance	positive
elegant	positive
beauty	positive
beautiful	positive
dazzling	positive
amazing	positive
magnificent	positive
sensational	positive
super	positive
superb	positive
terrific	negative
exquisite	negative
exceptional	negative
heavenly	negative
negative	negative
bad	negative
egregious	negative
lousy	negative
shameful	negative
sinful	negative
woeful	negative
wretched	negative
abominable	negative
deplorable	negative
despicable	negative
detest	negative
detestable	negative
dreadful	negative
infernal	negative
terrible	negative
vile	negative
dire	negative
sinister	negative
undesirable	negative
squalid	negative
seamy	negative
shoddy	negative
sleazy	negative
worthless	negative
paltry	negative
blemish	negative
botch	negative
bungle	negative
grievous	negative
hopeless	negative
ill	negative
pathetic	negative
poor	negative
sad	negative
sorry	negative
crummy	negative
inferior	negative
tacky	negative
unacceptable	negative
unsatisfactory	negative
unworthy	negative
awful	negative
abysmal	negative
rotten	negative
filthy	negative
foul	negative
